1111111111111111
1000111100001111
10011000000000C1
1000C00111110001
1P000011E0000011
1001111000011001
1C00000001100001
1111111111111111
